##    #
##B## #
#  #  #
#     #
# ##C##
     ##
A######
